000000000000000
000000000000000
000000000000000
000033333330000
004444402222200
004000402000200
004000402000200
004000402000200
004444402222200
000033333330000
000000000000000
000000000000000
000000000000000
